+-+-+-+-+-+-+-+
|       |     |
+-+ +-+ + +-+ +
|   | |   |   |
+-+-+ +-+-+ +-+
|     |   |   |
+ +-+ + + +-+ +
| | | | |     |
+ + + + +-+-+-+
| | |   |     |
+ + +-+-+ +-+ +
| |   |   | | |
+ + + +-+ + + +
|   |     |   |
+-+-+-+-+-+-+-+

