+-+-+-+-+-+-+-+
| |       |   |
+ + + +-+-+ + +
| | |   |   | |
+ + +-+ + +-+ +
|     | | | | |
+-+-+-+ +-+ + +
|   |       | |
+ + + +-+-+ + +
| |   |     | |
+ + +-+-+-+-+ +
| | |         |
+ +-+ +-+-+-+-+
|             |
+-+-+-+-+-+-+-+

